(supertux-level
  (version 3)
  (name (_ "Bridge In The Sky"))
  (author "Sophie \"Vaesea\" Ball")
  (license "CC-BY-SA 4.0 International")
  (target-time 62)
  (allow-item-pocket "inherit")
  (icon "")
  (icon-locked "")
  (statistics
    (enable-coins #t)
    (enable-secrets #t)
  )
  (sector
    (name "main")
    (ambient-light
      (color 1 1 1)
    )
    (background
      (scroll-offset-x 928)
      (scroll-offset-y 640)
      (color 1 1 1)
      (scroll-speed-x -50)
      (speed 1.5)
      (image-top "/images/background/fog.png")
      (image "/images/background/fog.png")
      (image-bottom "/images/background/fog.png")
      (z-pos 300)
    )
    (background
      (color 1 1 1)
      (speed 0.1)
      (image-top "/images/background/misc/transparent_up.png")
      (image "/images/background/bluemountain/bluemountain-middle.png")
      (image-bottom "/images/background/bluemountain/bluemountain-bottom.png")
      (z-pos -299)
    )
    (background
      (color 1 1 1)
      (alignment "bottom")
      (scroll-speed-x -15)
      (speed 1.5)
      (image "/images/background/misc/arcticskies3.png")
      (z-pos 301)
    )
    (bonusblock
      (z-pos 51)
      (count 3)
      (sprite "/images/objects/bonus_block/orangeblock.sprite")
      (x 10240)
      (y 384)
    )
    (camera
      (name "Camera")
      (mode "normal")
    )
    (decal
      (z-pos -100)
      (sprite "/images/decal/snow/exitbg.png")
      (x 15552)
      (y 480)
    )
    (decal
      (z-pos 100)
      (sprite "/images/decal/snow/exitfg.png")
      (x 15648)
      (y 480)
    )
    (firefly
      (z-pos 0)
      (x 6864)
      (y 480)
    )
    (gradient
      (top_color 0.5 0.7 1)
      (bottom_color 1 1 1)
    )
    (jumpy
      (z-pos 50)
      (x 1216)
      (y 544)
      (glinting #f)
    )
    (jumpy
      (z-pos 50)
      (x 3040)
      (y 576)
      (glinting #f)
    )
    (jumpy
      (z-pos 50)
      (x 3424)
      (y 576)
      (glinting #f)
    )
    (jumpy
      (z-pos 50)
      (x 3808)
      (y 576)
      (glinting #f)
    )
    (jumpy
      (z-pos 50)
      (x 6080)
      (y 480)
      (glinting #f)
    )
    (jumpy
      (z-pos 50)
      (x 9024)
      (y 448)
      (glinting #f)
    )
    (jumpy
      (z-pos 50)
      (x 10112)
      (y 448)
      (glinting #f)
    )
    (jumpy
      (z-pos 50)
      (x 13504)
      (y 800)
      (glinting #f)
    )
    (jumpy
      (z-pos 50)
      (x 2496)
      (y 544)
      (glinting #f)
    )
    (jumpy
      (z-pos 50)
      (x 5216)
      (y 480)
      (glinting #f)
    )
    (jumpy
      (z-pos 50)
      (x 7648)
      (y 480)
      (glinting #f)
    )
    (jumpy
      (z-pos 50)
      (x 14224)
      (y 704)
      (glinting #f)
    )
    (music
      (file "/music/antarctic/chipdisko.music")
    )
    (particles-clouds
    )
    (particles-snow
    )
    (path
      (name "gen17673930492284624638768")
      (path
        (mode "oneshot")
        (adapt_speed #f)
        (node
          (x 10560)
          (y 512)
        )
      )
    )
    (path
      (name "gen17673930542284624638192")
      (path
        (mode "oneshot")
        (adapt_speed #f)
        (node
          (x 10848)
          (y 512)
        )
      )
    )
    (path
      (name "gen17673930592284624639776")
      (path
        (mode "oneshot")
        (adapt_speed #f)
        (node
          (x 11136)
          (y 544)
        )
      )
    )
    (path
      (name "gen17673930622284624638048")
      (path
        (mode "oneshot")
        (adapt_speed #f)
        (node
          (x 11424)
          (y 576)
        )
      )
    )
    (path
      (name "gen17673930652284624638480")
      (path
        (mode "oneshot")
        (adapt_speed #f)
        (node
          (x 11712)
          (y 544)
        )
      )
    )
    (path
      (name "gen17673930682284624641072")
      (path
        (mode "oneshot")
        (adapt_speed #f)
        (node
          (x 12000)
          (y 512)
        )
      )
    )
    (platform
      (z-pos 50)
      (handle
        (scale_x 0)
        (scale_y 0)
        (offset_x 0)
        (offset_y 0)
      )
      (running #f)
      (path-ref "gen17673930492284624638768")
    )
    (platform
      (z-pos 50)
      (handle
        (scale_x 0)
        (scale_y 0)
        (offset_x 0)
        (offset_y 0)
      )
      (running #f)
      (path-ref "gen17673930542284624638192")
    )
    (platform
      (z-pos 50)
      (handle
        (scale_x 0)
        (scale_y 0)
        (offset_x 0)
        (offset_y 0)
      )
      (running #f)
      (path-ref "gen17673930592284624639776")
    )
    (platform
      (z-pos 50)
      (handle
        (scale_x 0)
        (scale_y 0)
        (offset_x 0)
        (offset_y 0)
      )
      (running #f)
      (path-ref "gen17673930622284624638048")
    )
    (platform
      (z-pos 50)
      (handle
        (scale_x 0)
        (scale_y 0)
        (offset_x 0)
        (offset_y 0)
      )
      (running #f)
      (path-ref "gen17673930652284624638480")
    )
    (platform
      (z-pos 50)
      (handle
        (scale_x 0)
        (scale_y 0)
        (offset_x 0)
        (offset_y 0)
      )
      (running #f)
      (path-ref "gen17673930682284624641072")
    )
    (sequencetrigger
      (sequence "endsequence")
      (width 32)
      (height 672)
      (x 15232)
      (y 0)
    )
    (sequencetrigger
      (sequence "stoptux")
      (width 96)
      (height 96)
      (x 15840)
      (y 640)
    )
    (smartball
      (z-pos 50)
      (direction "left")
      (x 3296)
      (y 448)
      (glinting #f)
    )
    (smartball
      (z-pos 50)
      (direction "left")
      (x 12640)
      (y 448)
      (glinting #f)
    )
    (smartball
      (z-pos 50)
      (direction "left")
      (x 12544)
      (y 448)
      (glinting #f)
    )
    (smartball
      (z-pos 50)
      (direction "left")
      (x 8096)
      (y 480)
      (glinting #f)
    )
    (smartblock
      (z-pos 50)
      (direction "left")
      (x 10336)
      (y 480)
      (glinting #f)
    )
    (snowball
      (z-pos 50)
      (direction "left")
      (x 2688)
      (y 608)
      (glinting #f)
    )
    (snowball
      (z-pos 50)
      (direction "left")
      (x 2816)
      (y 608)
      (glinting #f)
    )
    (snowball
      (z-pos 50)
      (direction "left")
      (x 2944)
      (y 608)
      (glinting #f)
    )
    (snowball
      (z-pos 50)
      (direction "left")
      (x 13824)
      (y 800)
      (glinting #f)
    )
    (snowball
      (z-pos 50)
      (direction "left")
      (x 14048)
      (y 800)
      (glinting #f)
    )
    (snowball
      (z-pos 50)
      (direction "left")
      (x 10240)
      (y 480)
      (glinting #f)
    )
    (snowball
      (z-pos 50)
      (direction "left")
      (x 10016)
      (y 480)
      (glinting #f)
    )
    (spawnpoint
      (name "main")
      (x 64)
      (y 640)
    )
    (stalactite
      (glinting #f)
      (z-pos -1)
      (x 7040)
      (y 224)
    )
    (stalactite
      (glinting #f)
      (z-pos -1)
      (x 7472)
      (y 224)
    )
    (stalactite
      (glinting #f)
      (z-pos -1)
      (x 9440)
      (y 64)
    )
    (stalactite
      (glinting #f)
      (z-pos -1)
      (x 9472)
      (y 64)
    )
    (stalactite
      (glinting #f)
      (z-pos -1)
      (x 9504)
      (y 64)
    )
    (stalactite
      (glinting #f)
      (z-pos -1)
      (x 9536)
      (y 64)
    )
    (stalactite
      (glinting #f)
      (z-pos -1)
      (x 9568)
      (y 64)
    )
    (stalactite
      (glinting #f)
      (z-pos -1)
      (x 9248)
      (y 64)
    )
    (stalactite
      (glinting #f)
      (z-pos -1)
      (x 9280)
      (y 64)
    )
    (stalactite
      (glinting #f)
      (z-pos -1)
      (x 9728)
      (y 64)
    )
    (stalactite
      (glinting #f)
      (z-pos -1)
      (x 9760)
      (y 64)
    )
    (tilemap
      (solid #f)
      (z-pos -100)
      (width 500)
      (height 35)
      (tiles -4888 0 122 123 -498 0 124 125 -82 0 122 123 -145 0 122 123 -197 0 122 123 -68 0 124 125 -82 0 124 125 -145 0 124 125 -67 0 122 123 -123 0 122 123 -3 0 124 125 -68 0 124 125 -82 0 124 125 0 130 -5 0 122 123 -136 0 124 125 -15 0 122 123 -50 0 124 125 0 122 123 -43 0 122 123 -75 0 124 125 -3 0 124 125 -68 0 124 125 0 106 107 108 -78 0 124 125 0 129 -5 0 124 125 -136 0 124 125 -15 0 124 125 -50 0 124 125 0 124 125 -43 0 124 125 -11 0 106 107 108 -58 0 106 107 108 124 125 -3 0 124 125 -65 0 25 -2 0 124 125 24 109 110 111 -78 0 124 125 0 129 -5 0 124 125 -127 0 2057 2060 2061 2066 2060 2061 2059 -2 0 124 125 -15 0 124 125 -13 0 122 123 -13 0 106 107 108 -19 0 124 125 0 124 125 -20 0 106 107 108 -20 0 124 125 -9 0 25 0 109 110 111 24 25 -26 0 -5 8 -25 0 109 110 111 124 125 25 0 24 124 125 -2 0 25 -149 0 124 125 0 129 -5 0 124 125 -86 0 122 123 -27 0 2057 2060 2061 2066 2060 2061 2059 -5 0 2057 2065 2066 2058 2065 2066 2059 -2 0 124 125 -15 0 124 125 -13 0 124 125 -10 0 24 25 0 109 110 111 -19 0 124 125 24 124 125 -19 0 24 109 110 111 25 -17 0 25 0 124 125 -234 0 124 125 0 129 -5 0 124 125 -21 0 122 123 -13 0 122 123 -9 0 122 123 -23 0 122 123 -12 0 124 125 -15 0 2057 2060 2061 2066 2060 2061 2059 -5 0 2057 2065 2066 2058 2065 2066 2059 -5 0 2057 2065 2058 2066 2065 2058 2059 -2 0 124 125 -15 0 124 125 -3 0 106 107 108 -7 0 124 125 -319 0 124 125 0 129 -5 0 124 125 -21 0 124 125 -10 0 122 123 0 124 125 -9 0 124 125 -23 0 124 125 -8 0 106 107 108 0 124 125 -6 0 24 25 -7 0 2057 2065 2066 2058 2065 2066 2059 -2 0 106 107 108 2057 2065 2058 2066 2065 2058 2059 -5 0 2057 2060 2061 2066 2060 2061 2059 -2 0 124 125 -3 0 106 107 108 -9 0 124 125 -3 0 109 110 111 24 -6 0 124 125 -249 0 24 -41 0 122 123 -26 0 124 125 0 129 -5 0 124 125 -21 0 124 125 -10 0 124 125 0 124 125 -9 0 124 125 -23 0 124 125 -8 0 109 110 111 24 124 125 0 25 -13 0 2057 2065 2058 2066 2065 2058 2059 24 0 109 110 111 2057 2060 2061 2066 2060 2061 2059 24 25 -3 0 2057 2065 2066 2058 2065 2066 2059 25 0 124 125 0 8 0 109 110 111 0 8 0 24 25 -2 0 8 0 124 125 -11 0 25 0 124 125 -276 0 122 123 -13 0 124 125 -26 0 124 125 0 129 -5 0 124 125 106 107 108 -14 0 108 -3 0 124 125 -4 0 106 107 108 -3 0 124 125 0 124 125 -6 0 106 107 108 124 125 -23 0 124 125 -367 0 122 123 -3 0 124 125 -13 0 124 125 -11 0 25 -12 0 25 0 124 125 0 129 -2 0 25 -2 0 124 125 109 110 111 -13 0 24 111 0 24 0 124 125 0 25 -2 0 109 110 111 24 25 0 124 125 0 124 125 -6 0 109 110 111 124 125 25 -20 0 25 0 124 125 25 -361 0 122 123 -3 0 124 125 -3 0 124 125 -13 0 124 125 -463 0 25 -9 0 124 125 -3 0 124 125 -3 0 124 125 -10 0 106 107 108 124 125 -473 0 124 125 -3 0 124 125 -3 0 124 125 -10 0 109 110 111 124 125 24 -472 0 124 125 -3 0 124 125 -3 0 124 125 -488 0 124 125 -3 0 124 125 -3 0 124 125 -2 0 24 -2 0 25 -482 0 124 125 25 -2 0 124 125 -4074 0)
    )
    (tilemap
      (solid #f)
      (z-pos 100)
      (width 500)
      (height 35)
      (tiles -6477 0 130 -499 0 129 -499 0 129 -499 0 129 -499 0 129 -499 0 129 -499 0 129 -499 0 129 -499 0 129 -7022 0)
    )
    (tilemap
      (solid #t)
      (z-pos 0)
      (width 500)
      (height 35)
      (tiles -214 0 10 -21 11 12 -48 0 10 -23 11 12 -404 0 10 -21 11 12 -48 0 10 -23 11 12 -404 0 10 -21 11 12 -48 0 16 -23 17 18 -404 0 10 -21 11 12 -477 0 10 -21 11 12 -477 0 10 -21 11 12 -440 0 44 0 44 -21 0 44 0 44 -10 0 10 -21 11 12 -439 0 44 -3 0 44 -19 0 44 -3 0 44 -9 0 16 -21 17 18 -1375 0 -3 83 -7 0 211 -477 0 -3 83 -19 0 212 -51 0 50 49 -5 0 50 49 -15 0 50 49 -5 0 50 49 -56 0 50 49 -5 0 50 49 -21 0 50 49 -5 0 50 49 -84 0 -5 83 -197 0 -3 83 -31 0 212 -3 0 -2 83 211 -44 0 48 51 52 -5 0 51 52 48 -13 0 48 51 52 -5 0 51 52 48 -41 0 -3 83 -9 0 50 49 51 52 -5 0 51 52 50 49 -17 0 50 49 51 52 -5 0 51 52 50 49 -15 0 83 0 83 -288 0 2067 -5 2068 2069 -5 0 212 -5 0 212 -31 0 44 -11 0 50 49 50 49 -5 0 50 49 50 49 -11 0 50 49 50 49 -5 0 50 49 50 49 -26 0 83 3161 83 -21 0 50 49 51 52 -2 48 -5 0 -2 48 51 52 50 49 -13 0 50 49 51 52 -2 48 -5 0 -2 48 51 52 50 49 -292 0 2067 -5 2068 2069 -5 0 2072 -5 2073 2074 -5 0 212 -5 0 212 -32 0 44 -9 0 48 51 52 51 52 -5 0 51 52 51 52 48 -9 0 48 51 52 51 52 -5 0 51 52 51 52 48 -11 0 50 49 -5 0 50 49 -27 0 50 49 51 52 50 49 50 49 -5 0 50 49 50 49 51 52 50 49 -9 0 50 49 51 52 50 49 50 49 -5 0 50 49 50 49 51 52 50 49 -76 0 7 -10 8 2913 2914 -151 0 3161 -14 0 44 -22 0 2067 -5 2068 2069 -5 0 2072 -5 2073 2074 -17 0 212 -5 0 212 -13 0 -3 83 -13 0 44 -11 0 50 49 50 49 50 49 -5 0 50 49 50 49 50 49 -7 0 50 49 50 49 50 49 -5 0 50 49 50 49 50 49 -8 0 50 49 51 52 -5 0 51 52 50 49 -14 0 7 -8 8 -2 48 51 52 -2 48 51 52 51 52 -5 2178 51 52 51 52 -2 48 51 52 -2 48 -5 44 -2 48 51 52 -2 48 51 52 51 52 -5 2178 51 52 51 52 -2 48 51 52 -2 48 -14 8 9 -59 0 13 -10 14 2915 2916 3139 3140 -69 0 50 49 -94 0 44 -21 0 2072 -5 2073 2074 -29 0 212 -2 0 27 28 29 212 105 83 -2 0 83 211 -22 0 44 -4 0 7 -6 8 48 51 52 51 52 51 52 -5 2178 51 52 51 52 51 52 48 -5 8 48 51 52 51 52 51 52 -5 2178 51 52 51 52 51 52 48 -6 8 48 51 52 -2 48 -5 2178 -2 48 51 52 48 -7 8 9 -5 0 13 -77 14 15 -23 0 -4 44 -32 0 10 -3 11 19 -7 11 1835 3143 3144 3149 -66 0 50 49 51 52 -53 0 44 0 44 -35 0 44 -60 0 212 -5 0 212 -5 0 212 -27 0 13 -77 14 15 -5 0 10 -3 11 19 -9 11 19 -13 11 19 -14 11 19 -15 11 19 -15 11 19 -2 11 12 -32 0 -4 44 -23 0 10 -8 11 19 -4 11 3147 3151 3152 -52 0 44 -10 0 50 49 51 52 50 49 -38 0 -3 83 -3 0 -3 83 -5 0 44 -3 0 44 -33 0 44 -14 0 2909 2910 -3 8 2913 2914 -40 0 212 -5 0 212 -5 0 212 -5 0 2909 2910 -3 8 2913 2914 -15 0 10 -11 11 19 -13 11 19 -13 11 19 -14 11 19 -10 11 19 -11 11 12 -5 0 16 -2 17 31 11 30 -67 17 31 11 30 -2 17 18 -59 0 10 -14 11 3155 3156 2917 2918 2913 2914 -49 0 44 -8 0 48 51 52 50 49 51 52 -67 0 48 50 49 -7 0 50 49 48 -15 0 7 -7 8 2921 2922 2911 2912 -3 14 2915 2916 2917 2918 -38 8 213 -5 8 213 -5 8 213 -3 8 2921 2922 2911 2912 -3 14 2915 2916 2917 2918 -7 8 9 -5 0 16 -2 17 31 11 30 -67 17 31 11 30 -2 17 18 -8 0 10 11 12 -67 0 10 11 12 -62 0 10 -3 11 19 -11 11 1835 2919 2920 2915 2916 3139 3140 -43 0 44 -11 0 50 49 50 49 51 52 50 49 -64 0 50 49 50 49 51 52 -7 0 51 52 50 49 50 49 -12 0 13 -7 14 2923 2924 1834 -3 11 19 11 1835 2919 2920 -54 14 2923 2924 1834 -3 11 19 11 1835 2919 2920 -7 14 15 -8 0 10 11 12 -67 0 10 11 12 -11 0 10 11 12 -67 0 10 19 12 -62 0 10 -7 11 19 -4 11 19 -6 11 1835 3143 3144 3149 -41 0 44 -5 0 7 -5 8 48 51 52 51 52 -2 48 51 52 -51 8 9 -5 0 7 -6 8 51 52 51 52 -2 48 -7 2178 -2 48 51 52 51 52 -6 8 9 -5 0 10 -7 11 19 -18 11 19 -9 11 19 -15 11 19 -17 11 19 -19 11 12 -8 0 10 11 12 -67 0 10 19 12 -11 0 10 11 12 -67 0 10 11 12 -62 0 10 -17 11 19 -3 11 3147 3151 3152 -46 0 13 -65 14 15 -5 0 13 -31 14 15 -5 0 16 -2 17 31 11 30 -80 17 31 11 30 -2 17 18 -8 0 10 19 12 -67 0 10 11 12 -11 0 10 11 12 -67 0 10 11 12 -62 0 10 -22 11 3155 3156 2917 2918 2913 2914 -42 0 10 -2 11 19 -21 11 19 -26 11 19 -13 11 12 -5 0 10 -4 11 19 -16 11 19 -9 11 12 -8 0 10 11 12 -80 0 10 11 12 -11 0 10 11 12 -67 0 10 11 12 -11 0 10 11 12 -67 0 10 11 12 -62 0 10 -10 11 19 -8 11 19 -3 11 1835 2919 2920 2915 2916 3139 3140 -3 0 83 78 83 -3 0 83 105 83 -14 0 7 -6 8 9 -6 0 16 -2 17 31 11 30 -28 17 2925 2926 -2 11 19 -6 11 -21 17 18 -5 0 16 -2 17 31 11 30 -21 17 31 11 30 -2 17 18 -8 0 10 11 12 -80 0 10 19 12 -11 0 10 11 12 -67 0 10 11 12 -11 0 10 11 12 -67 0 10 11 12 -62 0 10 -5 11 19 -17 11 19 -3 11 1835 3143 3144 3149 -25 0 13 -6 14 15 -9 0 10 11 12 -29 0 2928 2933 -7 11 19 -30 0 10 11 12 -21 0 10 11 12 -11 0 10 11 12 -80 0 10 11 12 -11 0 10 11 12 -67 0 10 11 12 -11 0 10 11 12 -67 0 10 11 12 -62 0 10 -2 11 19 -11 11 19 -11 11 19 -2 11 3147 3151 3152 -11 0 2909 2910 -11 8 22 11 19 -4 11 12 -9 0 10 11 12 -30 0 2934 2933 -7 11 -30 0 10 11 12 -21 0 10 11 12 -11 0 10 19 12 -80 0 10 11 12 -11 0 10 11 12 -67 0 10 11 12 -11 0 10 19 12 -67 0 10 11 12 -62 0 10 -20 11 19 -9 11 3155 3156 2917 2918 -7 8 2921 2922 2911 2912 -11 14 23 -2 11 19 -3 11 12 -9 0 10 11 12 -31 0 2934 2937 -6 11 -30 0 10 11 12 -21 0 10 11 12 -11 0 10 11 12 -80 0 10 11 12 -11 0 10 11 12 -67 0 10 11 12 -11 0 10 11 12 -67 0 10 11 12 -62 0 10 -15 11 19 -6 11 19 -3 11 19 -4 11 1835 2919 2920 -7 14 2923 2924 1834 -2 11 19 -16 11 12 -9 0 10 19 12 -32 0 2938 -5 11 115 -30 0 10 11 12 -21 0 10 11 12 -11 0 10 11 12 -80 0 10 11 12 -11 0 10 19 12 -67 0 10 11 12 -11 0 10 11 12 -67 0 10 19 12 -62 0 10 -7 11 19 -12 11 19 -8 11 19 -22 11 19 -10 11 12 -9 0 10 11 12 -32 0 2939 2937 -3 11 19 117 -30 0 10 11 12 -21 0 10 11 12 -11 0 10 11 12 -80 0 10 11 12 -11 0 10 11 12 -67 0 10 11 12 -11 0 10 11 12 -67 0 10 11 12 -62 0 10 -13 11 19 -10 11 19 -2 11 19 -5 11 19 -4 11 19 -9 11 19 -11 11 19 -2 11 12 -9 0 10 11 12 -33 0 2938 -5 11 -30 0 10 11 12 -21 0 10 11 12 -11 0 10 11 12 -80 0 10 11 12 -11 0 10 11 12 -67 0 10 11 12 -11 0 10 11 12 -67 0 10 11 12 -62 0 10 -2 11 19 -37 11 19 -2 11 19 11 19 -17 11 12 -9 0 10 11 12 -33 0 2939 2937 -4 11 -30 0 10 11 12 -21 0 10 11 12 -11 0 10 11 12 -80 0 10 11 12 -11 0 10 11 12 -67 0 10 19 12 -11 0 10 11 12 -67 0 10 11 12 -62 0 10 -9 11 19 -4 11 19 -5 11 19 -10 11 19 -7 11 115 116 -10 11 19 -2 11 19 -3 11 19 11 19 -2 11 12 -9 0 10 19 12 -34 0 2938 -4 11 -30 0 10 11 12 -21 0 10 11 12 -11 0 10 11 12 -80 0 10 11 12 -11 0 10 11 12 -67 0 10 11 12 -11 0 10 11 12 -67 0 10 11 12 -62 0 10 -17 11 19 -5 11 19 11 19 -7 11 19 -5 11 117 118 -16 11 19 -5 11 12 -9 0 10 11 12 -34 0 2939 2937 -3 11 -30 0 10 11 12 -21 0 10 11 12 -11 0 10 11 12 -80 0 10 11 12 -11 0 10 11 12 -67 0 10 11 12 -11 0 10 19 12 -67 0 10 11 12 -62 0 10 -3 11 19 -7 11 19 -17 11 19 -4 11 19 -11 11 19 -6 11 19 -9 11 12 -9 0 10 11 12 -35 0 2938 -2 11 19 -30 0 10 11 12 -21 0 10 11 12 -11 0 10 11 12 -80 0 10 11 12 -11 0 10 11 12 -67 0 10 11 12 -11 0 10 11 12 -67 0 10 11 12 -62 0 10 -63 11 12 -9 0 10 11 12 -35 0 2939 2937 -2 11)
    )
  )
)
